//MAP CONVERTED BY dmm2tgm.py THIS HEADER COMMENT PREVENTS RECONVERSION, DO NOT REMOVE
"a" = (
/obj/structure/chair/wood/alt/chair3,
/turf/open/floor/wood,
/area/indoors/town)
"b" = (
/obj/effect/decal/cleanable/dirt/dust,
/turf/open/floor/ruinedwood/turned/darker,
/area/indoors/town)
"d" = (
/turf/closed/wall/mineral/wooddark/end,
/area/indoors/town)
"e" = (
/obj/structure/table/wood/plain_alt,
/obj/machinery/light/fueled/torchholder{
	dir = 8
	},
/turf/open/floor/ruinedwood/turned/darker,
/area/indoors/town)
"f" = (
/obj/structure/table/wood/plain_alt,
/turf/open/floor/wood,
/area/indoors/town)
"g" = (
/obj/structure/chair/wood/alt,
/turf/open/floor/ruinedwood/turned/darker,
/area/indoors/town)
"h" = (
/turf/open/floor/wood,
/area/indoors/town)
"i" = (
/obj/machinery/light/fueled/hearth,
/obj/item/cooking/pan,
/turf/open/floor/ruinedwood/turned/darker,
/area/indoors/town)
"j" = (
/obj/structure/bookcase/random/myths,
/turf/open/floor/ruinedwood/turned/darker,
/area/indoors/town)
"m" = (
/obj/effect/abstract/property_noop{
	property_id = "apartment_four"
	},
/turf/template_noop,
/area/template_noop)
"n" = (
/turf/closed/wall/mineral/wooddark/end{
	dir = 1
	},
/area/indoors/town)
"o" = (
/turf/closed/wall/mineral/wooddark/horizontal,
/area/indoors/town)
"q" = (
/turf/closed/wall/mineral/wooddark/end{
	dir = 4
	},
/area/indoors/town)
"r" = (
/turf/open/floor/ruinedwood/turned/darker,
/area/indoors/town)
"s" = (
/obj/structure/window/solid,
/obj/structure/curtain/bounty{
	color = "grey"
	},
/turf/open/floor/ruinedwood/turned/darker,
/area/indoors/town)
"t" = (
/obj/structure/rack/shelf/biggest,
/turf/open/floor/wood,
/area/indoors/town)
"u" = (
/obj/machinery/light/fueled/oven{
	pixel_y = 31
	},
/turf/open/floor/wood,
/area/indoors/town)
"w" = (
/turf/closed/wall/mineral/wooddark,
/area/indoors/town)
"x" = (
/obj/structure/chair/wood/alt/chair3{
	dir = 8
	},
/turf/open/floor/wood,
/area/indoors/town)
"C" = (
/obj/structure/bed/inn/double,
/obj/item/bedsheet/double_pelt,
/turf/open/floor/wood,
/area/indoors/town)
"D" = (
/turf/closed/wall/mineral/wooddark/end{
	dir = 8
	},
/area/indoors/town)
"F" = (
/obj/structure/table/wood/plain_alt,
/obj/structure/fluff/millstone,
/turf/open/floor/ruinedwood/turned/darker,
/area/indoors/town)
"H" = (
/obj/structure/fermentation_keg/random/beer,
/turf/open/floor/ruinedwood/turned/darker,
/area/indoors/town)
"I" = (
/obj/structure/closet/crate/drawer,
/obj/item/coin/copper/pile,
/turf/open/floor/wood,
/area/indoors/town)
"J" = (
/obj/effect/decal/cleanable/dirt/dust,
/obj/machinery/light/fueled/wallfire/candle/l,
/turf/open/floor/wood,
/area/indoors/town)
"K" = (
/obj/structure/closet/crate/crafted_closet,
/obj/item/broom,
/turf/open/floor/ruinedwood/turned/darker,
/area/indoors/town)
"L" = (
/obj/structure/sign/property_sign/claim,
/turf/closed/wall/mineral/wooddark/end{
	dir = 8
	},
/area/indoors/town)
"M" = (
/obj/structure/bed/bear,
/turf/open/floor/wood,
/area/indoors/town)
"O" = (
/obj/effect/decal/cleanable/dirt/dust,
/turf/open/floor/wood,
/area/indoors/town)
"P" = (
/obj/structure/closet/crate/crafted_closet/inn,
/obj/item/key/apartments/apartment11,
/turf/open/floor/wood,
/area/indoors/town)
"Q" = (
/obj/effect/decal/cleanable/dirt/dust,
/obj/structure/closet/crate/crafted_closet,
/turf/open/floor/wood,
/area/indoors/town)
"S" = (
/obj/structure/door{
	lockid = "apartment11";
	name = "Apartment XI"
	},
/turf/open/floor/ruinedwood/turned/darker,
/area/indoors/town)
"U" = (
/obj/structure/table/wood/plain_alt,
/obj/item/reagent_containers/glass/cup/wooden,
/turf/open/floor/wood,
/area/indoors/town)
"V" = (
/obj/structure/chair/wood/alt{
	dir = 1
	},
/turf/open/floor/ruinedwood/turned/darker,
/area/indoors/town)
"W" = (
/obj/structure/table/wood/plain_alt,
/turf/open/floor/ruinedwood/turned/darker,
/area/indoors/town)
"X" = (
/turf/closed/wall/mineral/wooddark/vertical,
/area/indoors/town)
"Y" = (
/obj/machinery/light/fueled/wallfire/candle{
	pixel_x = 32;
	pixel_y = 0
	},
/turf/open/floor/wood,
/area/indoors/town)
"Z" = (
/obj/effect/decal/cleanable/dirt/dust,
/obj/effect/landmark/start/villager,
/turf/open/floor/wood,
/area/indoors/town)

(1,1,1) = {"
m
m
m
m
m
m
w
n
X
X
d
w
"}
(2,1,1) = {"
m
m
m
m
m
m
D
t
J
Q
f
D
"}
(3,1,1) = {"
m
m
m
m
m
m
q
u
h
h
x
o
"}
(4,1,1) = {"
w
n
X
s
X
d
w
I
h
h
h
o
"}
(5,1,1) = {"
L
i
H
b
j
K
D
Z
M
h
h
o
"}
(6,1,1) = {"
S
r
r
r
r
b
o
h
h
O
h
s
"}
(7,1,1) = {"
s
r
r
r
r
r
S
h
h
a
U
o
"}
(8,1,1) = {"
q
F
V
g
W
e
q
C
Y
O
P
q
"}
(9,1,1) = {"
w
n
X
s
X
d
m
m
m
m
m
m
"}
