//MAP CONVERTED BY dmm2tgm.py THIS HEADER COMMENT PREVENTS RECONVERSION, DO NOT REMOVE
"a" = (
/turf/closed/wall/mineral/wooddark/vertical,
/area/indoors/town)
"d" = (
/obj/structure/closet/crate/crafted_closet,
/obj/item/broom,
/turf/open/floor/wood,
/area/indoors/town)
"f" = (
/obj/machinery/light/fueled/wallfire/candle/r,
/turf/open/floor/wood,
/area/indoors/town)
"g" = (
/obj/effect/abstract/property_noop{
	property_id = "apartment_five"
	},
/turf/template_noop,
/area/template_noop)
"k" = (
/turf/closed/wall/mineral/wooddark/end{
	dir = 1
	},
/area/indoors/town)
"o" = (
/obj/structure/table/wood/plain_alt,
/obj/item/reagent_containers/glass/bowl,
/turf/open/floor/wood,
/area/indoors/town)
"p" = (
/turf/closed/wall/mineral/wooddark/end{
	dir = 8
	},
/area/indoors/town)
"y" = (
/obj/machinery/light/fueled/oven{
	pixel_y = 31
	},
/obj/effect/landmark/start/villager,
/turf/open/floor/wood,
/area/indoors/town)
"B" = (
/turf/closed/wall/mineral/wooddark/horizontal,
/area/indoors/town)
"C" = (
/obj/item/key/apartments/apartment5,
/obj/structure/closet/crate/crafted_closet/inn,
/turf/open/floor/wood,
/area/indoors/town)
"E" = (
/turf/closed/wall/mineral/wooddark/end,
/area/indoors/town)
"F" = (
/turf/open/floor/wood,
/area/indoors/town)
"G" = (
/obj/structure/bed/wool,
/obj/item/bedsheet/wool,
/turf/open/floor/wood,
/area/indoors/town)
"H" = (
/obj/structure/chair/wood/alt{
	dir = 4
	},
/turf/open/floor/wood,
/area/indoors/town)
"J" = (
/obj/structure/sign/property_sign/claim,
/turf/closed/wall/mineral/wooddark/end{
	dir = 8
	},
/area/indoors/town)
"K" = (
/obj/structure/table/wood/plain_alt,
/turf/open/floor/wood,
/area/indoors/town)
"L" = (
/turf/closed/wall/mineral/wooddark,
/area/indoors/town)
"P" = (
/obj/structure/window/solid,
/obj/structure/curtain/bounty{
	color = "grey"
	},
/turf/open/floor/ruinedwood/turned/darker,
/area/indoors/town)
"Q" = (
/turf/closed/wall/mineral/wooddark/end{
	dir = 4
	},
/area/indoors/town)
"T" = (
/obj/structure/chair/wood/alt{
	dir = 4
	},
/obj/effect/landmark/start/villager{
	dir = 4
	},
/turf/open/floor/wood,
/area/indoors/town)
"U" = (
/obj/structure/fermentation_keg/random/water,
/turf/open/floor/wood,
/area/indoors/town)
"Z" = (
/obj/structure/door{
	lockid = "apartment5";
	name = "Apartment V"
	},
/turf/open/floor/wood,
/area/indoors/town)

(1,1,1) = {"
L
k
a
a
E
L
"}
(2,1,1) = {"
p
C
F
F
T
p
"}
(3,1,1) = {"
B
y
F
F
K
P
"}
(4,1,1) = {"
Q
G
F
f
F
Q
"}
(5,1,1) = {"
L
k
Z
E
g
g
"}
(6,1,1) = {"
J
U
F
F
g
g
"}
(7,1,1) = {"
Z
F
F
H
g
g
"}
(8,1,1) = {"
Q
d
F
o
g
g
"}
(9,1,1) = {"
g
g
g
g
g
g
"}
