"au" = (/turf/closed/wall/mineral/rogue/decostone/cand,/area/rogue)
"aE" = (/obj/structure/trap/poison,/turf/open/floor/rogue/cobble,/area/rogue)
"aK" = (/turf/open/water/swamp,/area/rogue)
"bm" = (/mob/living/carbon/human/species/skeleton/npc/warrior/skilled,/turf/open/floor/rogue/cobble/alt,/area/rogue)
"bG" = (/obj/structure/fluff/railing/wood,/turf/open/floor/rogue/cobblerock,/area/rogue)
"bW" = (/obj/effect/decal/remains/human,/obj/structure/bars,/turf/open/floor/rogue/cobble,/area/rogue)
"cn" = (/obj/structure/trap/chill,/turf/open/floor/rogue/cobble,/area/rogue)
"co" = (/obj/structure/closet/crate/chest/old_crate,/obj/effect/spawner/roguemap/loot/magic,/turf/open/floor/rogue/cobble,/area/rogue)
"cz" = (/obj/structure/fluff/walldeco/chains,/mob/living/carbon/human/species/skeleton/npc/ambush,/turf/open/floor/rogue/cobble,/area/rogue)
"dc" = (/obj/structure/mineral_door/wood/violet,/turf/open/floor/rogue/cobble,/area/rogue)
"dw" = (/obj/effect/spawner/roguemap/loot/rare,/turf/open/floor/rogue/cobble,/area/rogue)
"dH" = (/obj/structure/spider/stickyweb,/obj/effect/decal/cleanable/blood/gibs,/turf/open/floor/rogue/cobble,/area/rogue)
"eD" = (/obj/effect/spawner/roguemap/treeorstump,/obj/structure/flora/roguegrass,/turf/open/floor/rogue/grass,/area/rogue)
"eT" = (/obj/machinery/light/rogue/firebowl,/obj/structure/trap/fire,/turf/open/floor/rogue/blocks/stonered/tiny,/area/rogue)
"eV" = (/obj/structure/bars/cemetery,/turf/open/floor/rogue/grass,/area/rogue)
"gP" = (/obj/effect/dungeon_directional_helper/east,/turf/open/floor/rogue/cobble/alt,/area/rogue)
"gV" = (/obj/structure/fluff/statue/knight,/turf/open/floor/rogue/blocks/stonered/tiny,/area/rogue)
"hd" = (/turf/open/floor/rogue/cobblerock,/area/rogue)
"hm" = (/obj/effect/decal/remains/cabbit,/obj/structure/flora/roguegrass/water/reeds,/turf/open/water/swamp,/area/rogue)
"hN" = (/obj/structure/closet/crate/chest/lootbox,/obj/effect/spawner/roguemap/loot/medium,/turf/open/floor/rogue/cobble,/area/rogue)
"hU" = (/obj/effect/decal/remains/cabbit,/turf/open/floor/rogue/cobble,/area/rogue)
"ia" = (/obj/effect/decal/cleanable/blood/gibs/core,/turf/open/floor/rogue/cobble/alt,/area/rogue)
"ie" = (/mob/living/simple_animal/hostile/retaliate/rogue/minotaur/axe,/turf/open/floor/rogue/cobble,/area/rogue)
"im" = (/obj/structure/flora/roguegrass,/obj/item/restraints/legcuffs/beartrap/armed/camouflage,/turf/open/floor/rogue/grass,/area/rogue)
"iR" = (/obj/structure/closet/dirthole/closed,/obj/structure/gravemarker,/turf/open/floor/rogue/grass,/area/rogue)
"iT" = (/mob/living/simple_animal/hostile/retaliate/rogue/spider,/turf/open/floor/rogue/cobble,/area/rogue)
"iZ" = (/obj/structure/trap/poison,/obj/effect/spawner/roguemap/loot/common,/turf/open/floor/rogue/cobble,/area/rogue)
"jd" = (/obj/structure/fluff/walldeco/stone,/turf/closed/wall/mineral/rogue/stone,/area/rogue)
"ju" = (/mob/living/carbon/human/species/skeleton/npc/warrior/skilled,/turf/open/floor/rogue/cobble,/area/rogue)
"jx" = (/obj/effect/decal/remains/human,/turf/open/floor/rogue/cobble/alt,/area/rogue)
"kd" = (/obj/structure/closet/crate/chest/neu_fancy,/obj/effect/spawner/roguemap/loot/medium,/turf/open/floor/rogue/cobble,/area/rogue)
"kk" = (/obj/structure/fluff/statue/knight/r,/turf/open/floor/rogue/blocks/stonered/tiny,/area/rogue)
"lp" = (/obj/effect/decal/remains/human{pixel_y = 5},/turf/open/floor/rogue/cobble/alt,/area/rogue)
"lz" = (/obj/structure/stairs/stone{dir = 4},/turf/open/floor/rogue/cobble,/area/rogue)
"lA" = (/turf/open/floor/rogue/grass,/area/rogue)
"lD" = (/obj/effect/decal/remains/bigrat,/turf/open/floor/rogue/cobble/alt,/area/rogue)
"lF" = (/obj/structure/bars,/turf/open/floor/rogue/cobble,/area/rogue)
"lL" = (/obj/structure/fluff/railing/wood,/obj/structure/fluff/railing/wood{dir = 4; pixel_x = 1},/turf/open/floor/rogue/cobblerock,/area/rogue)
"ms" = (/obj/structure/spider/stickyweb,/turf/open/floor/rogue/cobble,/area/rogue)
"mR" = (/obj/structure/closet/dirthole/closed,/obj/structure/gravemarker,/obj/structure/flora/roguegrass,/turf/open/floor/rogue/grass,/area/rogue)
"mW" = (/obj/effect/decal/cleanable/blood/footprints,/turf/open/floor/rogue/cobble,/area/rogue)
"nd" = (/turf/closed/wall/mineral/rogue/stone,/area/rogue)
"nt" = (/mob/living/simple_animal/hostile/retaliate/rogue/spider,/obj/effect/spawner/roguemap/loot/common,/turf/open/floor/rogue/cobble,/area/rogue)
"nH" = (/obj/structure/spider/stickyweb,/obj/effect/decal/cleanable/blood/footprints,/turf/open/floor/rogue/cobble/alt,/area/rogue)
"oN" = (/obj/structure/table/wood/counter/end,/obj/item/book/granter/spell/magick/greaterfireball{pixel_y = 11; pixel_x = 15},/turf/open/floor/rogue/blocks/stonered,/area/rogue)
"oQ" = (/obj/effect/decal/cleanable/blood/gibs/up,/turf/open/floor/rogue/cobble/alt,/area/rogue)
"pl" = (/obj/effect/decal/remains/human,/turf/open/floor/rogue/cobble,/area/rogue)
"pJ" = (/obj/effect/spawner/roguemap/loot/common,/turf/open/floor/rogue/cobble,/area/rogue)
"pP" = (/obj/structure/trap/fire,/turf/open/floor/rogue/blocks/stonered/tiny,/area/rogue)
"rc" = (/obj/item/restraints/legcuffs/beartrap/armed/camouflage,/turf/open/floor/rogue/cobblerock,/area/rogue)
"rl" = (/obj/structure/flora/roguegrass/bush,/obj/structure/flora/roguegrass,/turf/open/floor/rogue/grass,/area/rogue)
"rM" = (/obj/structure/spider/stickyweb,/obj/structure/closet/crate/chest/neu_fancy,/obj/effect/spawner/roguemap/loot/weapon,/turf/open/floor/rogue/cobble,/area/rogue)
"si" = (/obj/item/restraints/legcuffs/beartrap/armed/camouflage,/turf/open/floor/rogue/grass,/area/rogue)
"tA" = (/obj/item/restraints/legcuffs/beartrap/armed/camouflage,/turf/open/floor/rogue/dirt/road,/area/rogue)
"uB" = (/turf/open/floor/rogue/dirt/road,/area/rogue)
"uV" = (/obj/structure/spider/stickyweb,/obj/structure/spider/stickyweb,/turf/open/floor/rogue/cobble/alt,/area/rogue)
"wj" = (/obj/effect/decal/remains/bogbug,/obj/structure/flora/roguegrass/water/reeds,/turf/open/water/swamp,/area/rogue)
"wl" = (/obj/structure/flora/roguegrass/water/reeds,/turf/open/water/swamp,/area/rogue)
"wF" = (/turf/open/floor/rogue/cobble,/area/rogue)
"wH" = (/obj/structure/mineral_door/wood/deadbolt,/turf/open/floor/rogue/cobble,/area/rogue)
"wJ" = (/obj/effect/decal/remains/bogbug,/turf/open/floor/rogue/cobble,/area/rogue)
"ya" = (/obj/structure/bars,/obj/structure/bars,/turf/open/floor/rogue/cobble,/area/rogue)
"yk" = (/obj/effect/decal/remains/human{pixel_x = 12},/turf/open/floor/rogue/cobble/alt,/area/rogue)
"yo" = (/obj/structure/flora/roguegrass,/turf/open/floor/rogue/grass,/area/rogue)
"yI" = (/obj/machinery/light/rogue/firebowl/standing/blue,/turf/open/floor/rogue/cobblerock,/area/rogue)
"yK" = (/obj/effect/decal/remains/human,/obj/effect/spawner/roguemap/loot/rare,/turf/open/floor/rogue/cobble,/area/rogue)
"zm" = (/obj/effect/decal/cleanable/blood/footprints,/turf/open/floor/rogue/cobble/alt,/area/rogue)
"zu" = (/turf/open/floor/rogue/blocks,/area/rogue)
"AT" = (/obj/effect/spawner/roguemap/loot/potion_stats,/turf/open/floor/rogue/cobble,/area/rogue)
"Bt" = (/obj/item/ash{pixel_x = -10},/obj/item/ash{pixel_y = 6; pixel_x = 6},/obj/item/ash{pixel_y = 6; pixel_x = 6},/turf/open/floor/rogue/cobble,/area/rogue)
"CA" = (/obj/structure/stairs/stone{dir = 4},/turf/open/floor/rogue/blocks,/area/rogue)
"CL" = (/obj/structure/flora/roguegrass/water,/obj/item/restraints/legcuffs/beartrap/armed/camouflage,/turf/open/floor/rogue/dirt,/area/rogue)
"CN" = (/mob/living/simple_animal/hostile/retaliate/rogue/spider,/turf/open/floor/rogue/cobble/alt,/area/rogue)
"CO" = (/mob/living/carbon/human/species/skeleton/npc/ambush,/turf/open/floor/rogue/cobble,/area/rogue)
"Ed" = (/obj/structure/flora/roguegrass,/turf/closed/mineral/rogue/bedrock,/area/rogue)
"Ei" = (/obj/machinery/light/rogue/firebowl/standing/blue,/turf/open/floor/rogue/blocks,/area/rogue)
"Fg" = (/obj/structure/closet/crate/chest/lootbox,/obj/effect/spawner/roguemap/loot/rare,/turf/open/floor/rogue/cobble,/area/rogue)
"FC" = (/obj/machinery/light/rogue/firebowl,/turf/open/floor/rogue/blocks/stonered/tiny,/area/rogue)
"FO" = (/turf/open/floor/rogue/cobble/alt,/area/rogue)
"Ge" = (/obj/effect/dungeon_directional_helper/south,/turf/open/floor/rogue/cobble,/area/rogue)
"Gn" = (/obj/structure/table/wood/counter/end{dir = 1},/turf/open/floor/rogue/blocks/stonered,/area/rogue)
"GC" = (/obj/structure/flora/roguegrass/bush,/turf/open/floor/rogue/grass,/area/rogue)
"GY" = (/obj/structure/flora/roguegrass,/turf/open/floor/rogue/dirt,/area/rogue)
"Hd" = (/obj/item/restraints/legcuffs/beartrap/armed/camouflage,/turf/open/floor/rogue/dirt,/area/rogue)
"Iy" = (/obj/effect/decal/remains/human,/obj/structure/flora/roguegrass/water/reeds,/turf/open/water/swamp,/area/rogue)
"IJ" = (/obj/effect/decal/remains/bogbug,/turf/open/water/swamp,/area/rogue)
"IQ" = (/obj/effect/dungeon_directional_helper/west,/turf/open/floor/rogue/cobble/alt,/area/rogue)
"Jd" = (/obj/effect/spawner/roguemap/treeorstump,/obj/item/restraints/legcuffs/beartrap/armed/camouflage,/turf/open/floor/rogue/grass,/area/rogue)
"Jf" = (/obj/effect/decal/remains/human{pixel_y = 5},/turf/open/floor/rogue/cobble,/area/rogue)
"Jo" = (/obj/effect/spawner/roguemap/loot/potion_stats,/turf/open/floor/rogue/cobble/alt,/area/rogue)
"JZ" = (/obj/structure/trap/fire,/turf/open/floor/rogue/blocks/stonered,/area/rogue)
"Kn" = (/obj/structure/fluff/walldeco/chains,/turf/closed/wall/mineral/rogue/stone,/area/rogue)
"Kr" = (/obj/effect/decal/remains/human,/turf/open/water/swamp,/area/rogue)
"KI" = (/obj/structure/closet/dirthole/closed/loot,/obj/structure/gravemarker,/turf/open/floor/rogue/grass,/area/rogue)
"La" = (/obj/effect/spawner/roguemap/treeorstump,/turf/open/floor/rogue/grass,/area/rogue)
"Ln" = (/mob/living/carbon/human/species/skeleton/npc/ambush,/turf/open/floor/rogue/cobble/alt,/area/rogue)
"LB" = (/obj/effect/spawner/roguemap/treeorstump,/turf/open/floor/rogue/dirt,/area/rogue)
"LM" = (/obj/structure/trap/shock,/turf/open/floor/rogue/cobble,/area/rogue)
"LR" = (/turf/closed/mineral/rogue/bedrock,/area/rogue)
"Mo" = (/turf/open/floor/rogue/blocks/stonered,/area/rogue)
"MB" = (/obj/structure/spider/stickyweb,/obj/structure/spider/stickyweb,/turf/open/floor/rogue/cobble,/area/rogue)
"ML" = (/obj/effect/decal/remains/bigrat,/obj/structure/flora/roguegrass/water/reeds,/turf/open/water/swamp,/area/rogue)
"NM" = (/turf/closed/wall/mineral/rogue/stone/moss,/area/rogue)
"OH" = (/turf/open/floor/rogue/blocks/stonered/tiny,/area/rogue)
"Pu" = (/obj/structure/flora/roguegrass/water,/turf/open/floor/rogue/dirt,/area/rogue)
"PZ" = (/obj/item/restraints/legcuffs/beartrap/armed/camouflage,/turf/open/floor/rogue/blocks,/area/rogue)
"Qe" = (/obj/structure/trap/poison,/turf/open/floor/rogue/cobble/alt,/area/rogue)
"Qm" = (/turf/open/transparent/openspace,/area/rogue)
"Rn" = (/obj/structure/mineral_door/bars,/turf/open/floor/rogue/grass,/area/rogue)
"RF" = (/obj/structure/fluff/statue/astrata,/obj/structure/trap/fire,/turf/open/floor/rogue/blocks/stonered,/area/rogue)
"Tt" = (/obj/item/ash{pixel_y = -6},/obj/item/ash{pixel_y = 6},/obj/item/ash{pixel_x = -10},/turf/open/floor/rogue/cobble,/area/rogue)
"UD" = (/obj/effect/dungeon_directional_helper/north,/turf/open/floor/rogue/cobble,/area/rogue)
"UF" = (/obj/structure/trap/poison,/turf/open/floor/rogue/cobblerock,/area/rogue)
"UW" = (/obj/structure/mineral_door/wood/donjon/stone,/turf/open/floor/rogue/cobble,/area/rogue)
"Vk" = (/obj/item/clothing/ring/gold/rontz,/turf/open/floor/rogue/cobblerock,/area/rogue)
"Vr" = (/obj/structure/fluff/railing/wood{dir = 4; pixel_x = 1},/turf/open/floor/rogue/cobblerock,/area/rogue)
"WC" = (/obj/structure/fluff/walldeco/chains,/turf/open/floor/rogue/cobble,/area/rogue)
"WG" = (/turf/open/floor/rogue/dirt,/area/rogue)
"Xp" = (/obj/structure/fluff/walldeco/chains,/obj/structure/closet/crate/chest/neu_fancy,/obj/effect/spawner/roguemap/loot/armor,/turf/open/floor/rogue/cobble,/area/rogue)
"Ya" = (/obj/structure/spider/stickyweb,/turf/open/floor/rogue/cobble/alt,/area/rogue)
"Zr" = (/obj/effect/decal/cleanable/blood/gibs/torso,/turf/open/floor/rogue/cobble,/area/rogue)
"ZB" = (/mob/living/carbon/human/species/skeleton/npc/no_equipment,/turf/open/floor/rogue/cobble,/area/rogue)

(1,1,1) = {"
ndndndndndndndndndndndndndwFUDwFndndndndndndndndndndndndndnd
ndmsaEFgndmsmswFwFZBWCmswFmsmswFmsndrMwFmsmsmswFdcwFwFdcwFnd
ndiTFOhNndwFCOwFmsmswFwFaEmswFmswFndwFmsQemsWCCNndwFwFndwFnd
ndoQmsndndnddcndjdlFlFlFjdlFlFlFndndiTiTYaFOcnFOndwFFOlFLnnd
ndYaiTlFmslpwFndWCmswFwFdwmsFOLnaEnddcndndndndndndFOFOlFFOnd
nddHwFlFwFYaiTndCOwFaEmsmsmswFFOYawFWCwFwFndlzwFwFFOFOlFaEnd
ndzmialFntYaJondwFwFwFwFwFwFmswFmsmswFwFZBndlzwFwFFOplndFOnd
ndmsQendmsFOmsndwFmsndlFlFlFlFndndyalFlFlFndnddcndndndnddcnd
ndZrnHndFOYaMBndwFCOlFwlwlwlMLwlwlwlwlwlwlwlndmsCOndiTwFwFnd
ndwFmWndFOFOmsndmswFlFwlaKaKaKaKIJaKaKKraKwlndmsmsndwFwFcnnd
ndwFwFndmsYaiTndwFmslFwlKrwFwFwFwFwFwFaKIJwllFcnmslFwFplwFnd
ndmsiTwFwFFOmsndLMwFlFIywFwFwFwFhUwFwFFOaKwllFwFmslFwFwFwFnd
ndwFwFwFmswFwFndwFmsndwlhUwJwFwFwFwFlDFOaKIylFCOwFlFwFmsmsnd
nddcdcndlFlFlFnddcndndwlaKwFiewFyKFOFOwFwJwllFwFmslFwFmsFOnd
msmswFndXpkdCOwFwFwFlFhmaKwFdwcowFwFhUwFwFwlndATmsndmsFOFOFO
IQYawFndJfwFwFWCwFwFlFwlFOFOplwFwFiewFFOFOwlndmswFndwFFOFOgP
wFFOWCndCOwFwFwFJfZBlFwlwFjxFOwFwFwFFOFOFOwllFmsCOlFmsFOFOFO
ndFOmsndnddcndndndndbWwlaKwFwFFOwFwFjxFOaKwllFwFwFlFmsYawFnd
ndFOYalFwFpJmsiTlFwlIywlaKaKwFaKKrKraKwFaKwllFmswFlFwFFOmsnd
ndaEyklFwFwFmswFlFwlwlwlwlIywlwlwlwlwlwlwjwllFmsmslFmsmswFnd
ndwFYalFwFmswFwFndlFlFlFlFndndlFlFlFlFlFKnndndwFwFndlFlFndnd
ndwFwFndiTmswFmsndiZwFwFmsmsZBwFwFcnwFwFwFwFwFwFFOLnjuFOwFnd
ndmswFndwFmspJwFndZBmswFwFwFwFplwFFOwFwFwFbmFOTtBtcnwFwFFOnd
ndwFwFndlFlFnddcndndlFndlFndwFndndwFndndndndndwHwHndndndCOKn
ndWCFOYaFOwFFOFOjxQewFwFmslFaEwFwFwFCOndndgVOHOHOHpPkkndndnd
ndaEwFwFiTmsmswFwFFOFOmswFndnddcndndndndOHOHpPJZJZOHpPOHndnd
ndnddcndndndnddcndndndwFFOmsmswFwFwFWCndeTgVMoRFMoMokkFCndnd
ndwFCOwFmsmsYaLnYahNndmsFOwFplwFmswFwFndOHpPMoMoMoMopPOHndnd
ndwFwFaEczuVwFmsYahNndmswFFOFOFOwFmswFndndgVpPoNGnpPkkndndnd
ndndndndndndndndndndndndndwFGeFOndndndndndndndndndndndndndnd
"}
(1,1,2) = {"
LRLRLRLRLRLRLRLRLRLRLRLRlAlAlAlAlAauaundndauauLRLRLRLRLRLRLR
LRLRLRLRLRLRLRLRLRLRLRlAsiuBuBuBWGNMEizuzuzuEindndLRLRLRLRLR
LRLRLRLRLRLRLRLRlAlAGClAlAWGPuuBPuNMzuzuzuzuzuzuVrauLRLRLRLR
LRLRLRLRlAGClAlAlAlALBWGWGWGuBuBlAauzuzuzuzuzuzuVrQmauLRLRLR
LRLRLRlAlAlAGCyolAWGWGHduBuBuBtAWGauzuzuhdbGbGbGlLQmndLRLRLR
LRLRlAlAyoJdlAlAWGPuuBuBuBWGuBuBWGndzuzuhdCAQmQmQmQmQmndLRLR
LRLRlALalAyolAlAWGuBuBWGWGWGPuWGlAndzuzuhdCAQmQmQmQmQmndLRLR
LRLRlAlAlAyoLaWGuBuBndNMauaundndauauhdndndzuaundndauauNMndLR
LRLRyoyoGClAWGWGuBuBauQmQmQmyIhdhdQmhdndndzuauiRlAiRlAKIlALR
LRlAeDlAlAlAWGuBndndauQmQmQmhdhdhdQmhdhdhdzuNMlAlAlAGClAlALR
LRlAlAlAlAWGCLWGauzuhdQmQmQmQmQmQmQmQmQmhdzundKIsimRyomRlALR
LRlALayoWGuBWGlAauzuhdQmQmhdhdQmQmQmQmQmhdzuaulAyolAlAlAlALR
LRlAlAlAuBuBWGlAndzuhdQmQmhdhdQmQmQmQmQmhdPZauRneVeVeVeVeVLR
lAlAlAuBuBuBlAyondzuhdQmQmQmQmQmQmQmQmhdhdzundlAlAlAlAGClAlA
lAuBtAuBWGWGlAyoUWzuhdQmhdhdQmQmQmhdhdhdEizundlAGCGYyolAuBlA
lAuBPuPuuBuBlAyoUWzuhdQmhdhdQmQmQmrchdhdzuhdaulAlAimuBuBWGyo
lAuBuBWGuBuBlAlANMzuhdQmQmQmQmQmQmQmQmhdhdQmauWGlAlAuBuBPuyo
yoyouBuBuBuBsilAndhdhdQmQmQmQmQmQmQmQmQmQmQmndWGuBuBWGWGWGlA
lAyolAuBuBWGWGlAauQmQmQmQmQmQmQmQmQmQmQmQmQmndlAuBWGPuWGlALR
LRGClAuBPuuBWGWGauQmhdQmhdQmUFVkyIQmQmQmQmQmauuBuBWGWGlArlLR
LRyoLalAuBPuuBuBndndauaundNMauauNMndauaundndauuBuBWGlAlAyoLR
LRyolAlAuBWGWGuBlAlAlAlAlAlAlAlAlAlAGClAPuWGuBuBlAWGlAyoLRLR
LRyoGClAuBuBuBtAuBWGPuWGlAGCyoyolAlAlAlAWGWGHdPulAyoLalALRLR
LRLRlAGClAGCuBuBuBuBuBWGPulAlAlAyoeDyoWGWGWGPuyorllAlALRLRLR
LRLRLREdyolAlAuBuBuBuBWGuBuBWGsiGClAlAWGuBWGlAyosilALRLRLRLR
LRLRLRLRlAlAyoeDyolAlAuBuBuBWGWGWGlAWGuBuBlAyolAGCLRLRLRLRLR
LRLRLRLRLRlAyoyoeDyolAlAuBuBuBuBuBuBuBuBlAWGLalALRLRLRLRLRLR
LRLRLRLRLRLRlAlArlyosiLauBWGWGuBWGtAuBlAlAlAlALRLRLRLRLRLRLR
LRLRLRLRLRLRLRLRlAlAyoGClAuBuBuBWGWGlAlAlALRLRLRLRLRLRLRLRLR
LRLRLRLRLRLRLRLRLRLRLRLRlAuBuBuBlAlALRLRLRLRLRLRLRLRLRLRLRLR
"}
