"a" = (/turf/closed/mineral/rogue/bedrock,/area/rogue/under/cave)
"e" = (/obj/effect/dungeon_directional_helper/north,/turf/open/floor/rogue/naturalstone,/area/rogue/under/cave)
"g" = (/obj/item/natural/rock/coal,/turf/open/floor/rogue/volcanic,/area/rogue/under/cave)
"h" = (/obj/structure/flora/rock,/turf/open/floor/rogue/naturalstone,/area/rogue/under/cave)
"m" = (/obj/item/natural/rock/coal,/turf/open/floor/rogue/naturalstone,/area/rogue/under/cave)
"p" = (/turf/open/floor/rogue/volcanic,/area/rogue/under/cave)
"r" = (/obj/item/natural/rock/gemerald,/turf/open/floor/rogue/volcanic,/area/rogue/under/cave)
"x" = (/turf/open/floor/rogue/naturalstone,/area/rogue/under/cave)
"y" = (/obj/structure/stairs/stone/reddish{dir = 1},/turf/open/transparent/openspace,/area/rogue/under/cave)
"z" = (/obj/structure/flora/rock/pile,/turf/open/floor/rogue/naturalstone,/area/rogue/under/cave)
"D" = (/obj/item/natural/rock/random_ore,/turf/open/floor/rogue/volcanic,/area/rogue/under/cave)
"F" = (/obj/effect/dungeon_directional_helper/west,/turf/open/floor/rogue/naturalstone,/area/rogue/under/cave)
"G" = (/obj/item/natural/rock/random_ore,/turf/open/floor/rogue/naturalstone,/area/rogue/under/cave)
"H" = (/turf/open/transparent/openspace,/area/rogue/under/cave)
"O" = (/mob/living/carbon/human/species/goblin/npc/ambush/cave,/turf/open/floor/rogue/naturalstone,/area/rogue/under/cave)
"S" = (/obj/effect/dungeon_directional_helper/east,/turf/open/floor/rogue/naturalstone,/area/rogue/under/cave)
"U" = (/turf/open/lava,/area/rogue/under/cave)
"W" = (/obj/structure/stairs/stone/reddish{dir = 1},/turf/open/floor/rogue/naturalstone,/area/rogue/under/cave)
"X" = (/obj/effect/dungeon_directional_helper/south,/turf/open/floor/rogue/naturalstone,/area/rogue/under/cave)

(1,1,1) = {"
aaaaDexaaa
aaaUDxxaaa
aUUUxxrpaa
xppgpaUrxa
FxxxxaaOxS
mxpxxWWxxx
aUaaOxxxDD
aaaUpxxpDa
aaUUDxxxaa
aaaaGXxaaa
"}
(1,1,2) = {"
aaaxxxaaaa
aaaGGxxaaa
aaaaGxxhxa
azaaxOxxxx
xxxxxyyaGx
xxxxaHHaxG
xGaxxaaaaa
aGaaxxahaa
aaaGxxxxaa
aaaaGxxaaa
"}
