"a" = (/turf/open/floor/rogue/naturalstone,/area/rogue/under/cave)
"b" = (/mob/living/carbon/human/species/goblin/npc/ambush/cave,/obj/structure/fluff/nest,/turf/open/floor/rogue/volcanic,/area/rogue/under/cave)
"c" = (/obj/effect/decal/cleanable/blood,/turf/open/floor/rogue/volcanic,/area/rogue/under/cave)
"d" = (/obj/structure/stairs/stone/reddish{dir = 4},/turf/open/floor/rogue/naturalstone,/area/rogue/under/cave)
"e" = (/turf/open/lava,/area/rogue/under/cave)
"f" = (/obj/effect/decal/cleanable/blood/gibs/torso,/obj/effect/decal/cleanable/blood,/mob/living/carbon/human/species/goblin/npc/ambush/cave,/turf/open/floor/rogue/naturalstone,/area/rogue/under/cave)
"g" = (/obj/structure/roguerock,/turf/open/floor/rogue/volcanic,/area/rogue/under/cave)
"h" = (/mob/living/carbon/human/species/goblin/npc/ambush/cave,/turf/open/floor/rogue/volcanic,/area/rogue/under/cave)
"i" = (/obj/item/natural/rock/random_ore,/obj/item/natural/rock/random_ore,/turf/open/floor/rogue/naturalstone,/area/rogue/under/cave)
"l" = (/obj/item/rogueweapon/pick/steel,/obj/effect/decal/cleanable/blood/gibs/body,/obj/effect/decal/cleanable/blood,/turf/open/floor/rogue/volcanic,/area/rogue/under/cave)
"m" = (/obj/structure/stairs/stone/reddish{dir = 1},/turf/open/floor/rogue/naturalstone,/area/rogue/under/cave)
"n" = (/obj/effect/decal/cleanable/blood/tracks,/turf/open/floor/rogue/plank,/area/rogue/under/cave)
"q" = (/obj/effect/decal/cleanable/blood/splatter,/turf/open/floor/rogue/naturalstone,/area/rogue/under/cave)
"r" = (/obj/item/natural/rock/random_ore,/mob/living/carbon/human/species/goblin/npc/ambush/cave,/turf/open/floor/rogue/naturalstone,/area/rogue/under/cave)
"t" = (/obj/effect/dungeon_directional_helper/east,/turf/open/floor/rogue/naturalstone,/area/rogue/under/cave)
"u" = (/turf/closed/mineral/rogue/bedrock,/area/rogue/under/cave)
"x" = (/turf/open/transparent/openspace,/area/rogue/under/cave)
"y" = (/obj/item/natural/rock/random_ore,/mob/living/carbon/human/species/goblin/npc/ambush/cave,/turf/open/floor/rogue/volcanic,/area/rogue/under/cave)
"A" = (/obj/effect/decal/cleanable/blood/footprints,/turf/open/floor/rogue/volcanic,/area/rogue/under/cave)
"B" = (/obj/effect/dungeon_directional_helper/south,/turf/open/floor/rogue/naturalstone,/area/rogue/under/cave)
"C" = (/obj/effect/dungeon_directional_helper/west,/turf/open/floor/rogue/naturalstone,/area/rogue/under/cave)
"D" = (/obj/effect/dungeon_directional_helper/north,/turf/open/floor/rogue/naturalstone,/area/rogue/under/cave)
"F" = (/obj/effect/decal/cleanable/blood/footprints,/turf/open/floor/rogue/plank,/area/rogue/under/cave)
"G" = (/obj/item/natural/rock/random_ore,/turf/open/floor/rogue/naturalstone,/area/rogue/under/cave)
"H" = (/obj/effect/decal/cleanable/blood/gibs/down,/obj/effect/decal/cleanable/blood/tracks,/turf/open/floor/rogue/volcanic,/area/rogue/under/cave)
"I" = (/obj/effect/decal/cleanable/blood/gibs/down,/obj/effect/decal/cleanable/blood,/mob/living/carbon/human/species/goblin/npc/ambush/cave,/turf/open/floor/rogue/naturalstone,/area/rogue/under/cave)
"J" = (/turf/open/floor/rogue/plank,/area/rogue/under/cave)
"K" = (/obj/item/natural/rock/gemerald,/turf/open/floor/rogue/volcanic,/area/rogue/under/cave)
"L" = (/obj/structure/roguerock,/turf/open/floor/rogue/naturalstone,/area/rogue/under/cave)
"M" = (/turf/open/floor/rogue/volcanic,/area/rogue/under/cave)
"N" = (/obj/item/rogueweapon/pick/steel,/obj/effect/decal/cleanable/blood,/turf/open/floor/rogue/naturalstone,/area/rogue/under/cave)
"P" = (/obj/effect/decal/cleanable/blood/tracks,/turf/open/floor/rogue/naturalstone,/area/rogue/under/cave)
"Q" = (/obj/item/natural/rock/random_ore,/obj/structure/fluff/nest,/turf/open/floor/rogue/volcanic,/area/rogue/under/cave)
"R" = (/turf/open/floor/rogue/plank/h,/area/rogue/under/cave)
"S" = (/obj/structure/fluff/nest,/turf/open/floor/rogue/naturalstone,/area/rogue/under/cave)
"T" = (/obj/structure/stairs/stone/reddish{dir = 4},/turf/open/floor/rogue/volcanic,/area/rogue/under/cave)
"U" = (/obj/effect/decal/cleanable/blood/gibs,/obj/effect/decal/cleanable/blood,/turf/open/floor/rogue/volcanic,/area/rogue/under/cave)
"V" = (/obj/effect/decal/cleanable/blood/gibs/body,/obj/effect/decal/cleanable/blood/gibs/core,/obj/effect/decal/cleanable/blood,/turf/open/floor/rogue/naturalstone,/area/rogue/under/cave)
"W" = (/obj/item/natural/rock/random_ore,/turf/open/floor/rogue/volcanic,/area/rogue/under/cave)
"X" = (/obj/effect/decal/cleanable/blood/footprints,/obj/effect/decal/cleanable/blood/footprints,/turf/open/floor/rogue/volcanic,/area/rogue/under/cave)
"Y" = (/obj/structure/fluff/nest,/turf/open/floor/rogue/volcanic,/area/rogue/under/cave)
"Z" = (/obj/item/natural/rock/gemerald,/turf/open/floor/rogue/naturalstone,/area/rogue/under/cave)

(1,1,1) = {"
uuuuuuuuMaDMuuuuuuuu
uuuuuueMMaaaaLuueeuu
ueeuuuuMMMaaaMMeeeeu
uueeuuKWaMaMMaGeeeeu
uuMMWKWGaMMMaaiWeeeu
uugaaWGaMMMMMaGWKeuu
uMMMaaaMauuuMMWWKuuu
uaaMMMahuuuuuaaLWuuu
MMaGGMaMummaaaMauuuu
aMMuGMMMMaaShWWaauMM
CaauWWhSaaaMbuWGMMat
aaMuuWaaSaaaduuGMaaa
uaMaLMaMaMaauuuaaaaM
uMMaMMaMMSaaaaMaaMgu
uuaaWGGueuuMaaaGMMuu
ueaGGGueeuMMaaWMueuu
ueeeZWeeugMaaGueueeu
ueueeueuuMaaauueeueu
ueeeeeeuMaaaMueeeeeu
uuuuuuuuaaBauuuuuuuu
"}
(1,1,2) = {"
uuuuuuuuaMMGuuuuuuuu
uuuuuuuuaMWuuuMMRIlu
uxxuuuuGWMGuuWMxxxUu
uMxxuuGWMaaaLaMxxxFu
uWgaMaaMMMMaaiWuxxFu
uWGMMMMhMMMMaGuuuxAu
uGaMuMaLaaMMWWuuLaXu
uMMMuuuuSmmYWuuuMMuu
MMMMguuuuxxuuuuuaMuu
MMaaMuuuuuuuuugWaaMM
aauuGYuuuuuuuaaWyaaa
aauuGWQuuuuuxTaaGaaa
uaguMWuuuuuuuMMMauuM
uMMMMuuuuuuuYMMMMMuu
uGMuuuuuxuuuuugMaPuu
uxauuuqxxSQuuuuuunau
uxJxurMRMaWWWuuxVnxu
uuMaRaxuMaaaWMaRcHxu
uuuGxxuugaMMMqxxxfNu
uuuuuuuuMMMauuuuuuuu
"}
