//MAP CONVERTED BY dmm2tgm.py THIS HEADER COMMENT PREVENTS RECONVERSION, DO NOT REMOVE
"bp" = (
/turf/open/water/swamp/deep,
/area/under/tomb/cave/wet)
"cy" = (
/obj/effect/decal/cleanable/sigil/NE,
/turf/open/floor/ruinedwood/spiral,
/area/under/tomb/indoors)
"cA" = (
/obj/effect/decal/cleanable/sigil/SW,
/turf/open/floor/ruinedwood/spiral,
/area/under/tomb/indoors)
"dx" = (
/obj/machinery/light/fueled/wallfire/candle/blue,
/obj/structure/table/vtable,
/obj/item/storage/belt/pouch,
/turf/open/floor/ruinedwood/spiral,
/area/under/tomb/indoors)
"eS" = (
/obj/effect/decal/cleanable/sigil/N,
/obj/machinery/light/fueled/wallfire/candle/blue,
/turf/open/floor/ruinedwood/spiral,
/area/under/tomb/indoors)
"fo" = (
/obj/structure/bed/inn/double,
/obj/item/bedsheet/fabric_double,
/turf/open/floor/ruinedwood/spiral,
/area/under/tomb/indoors)
"hc" = (
/obj/structure/door/fancy,
/obj/effect/mapping_helpers/access/locker,
/obj/item/soap/bath{
	pixel_y = -5
	},
/turf/open/floor/ruinedwood/spiral,
/area/under/tomb/indoors)
"hr" = (
/turf/closed/mineral/bedrock,
/area/under/tomb/cave/wet)
"ht" = (
/obj/structure/bed/shit,
/turf/open/floor/ruinedwood/spiral,
/area/under/tomb/indoors)
"hA" = (
/obj/machinery/light/fueled/wallfire/candle/blue/r,
/turf/open/floor/ruinedwood/spiral,
/area/under/tomb/indoors)
"hL" = (
/mob/living/carbon/human/species/skeleton/npc/ambush,
/turf/open/floor/ruinedwood/spiral,
/area/under/tomb/indoors)
"hU" = (
/obj/structure/bed/shit,
/obj/item/statue/iron,
/turf/open/floor/ruinedwood/spiral,
/area/under/tomb/indoors)
"il" = (
/obj/structure/stairs/d,
/turf/open/floor/ruinedwood/spiral,
/area/under/tomb/indoors)
"iy" = (
/obj/structure/closet/crate/crafted_closet/inn,
/obj/item/statue/silver,
/turf/open/floor/ruinedwood/spiral,
/area/under/tomb/indoors)
"iO" = (
/obj/effect/decal/cleanable/sigil/W,
/mob/living/carbon/human/species/skeleton/npc/warrior,
/turf/open/floor/ruinedwood/spiral,
/area/under/tomb/indoors)
"jl" = (
/mob/living/carbon/human/species/skeleton/npc/ambush,
/turf/open/water/bath,
/area/under/tomb/indoors)
"js" = (
/obj/structure/bed/shit,
/mob/living/carbon/human/species/skeleton/npc/peasant,
/turf/open/floor/ruinedwood/spiral,
/area/under/tomb/indoors)
"jL" = (
/obj/item/soap/bath{
	pixel_y = -5
	},
/turf/open/water/bath,
/area/under/tomb/indoors)
"jV" = (
/turf/closed/wall/mineral/decowood,
/area/under/tomb/indoors)
"jX" = (
/obj/structure/door/fancy,
/obj/effect/mapping_helpers/access/locker,
/turf/open/floor/ruinedwood/spiral,
/area/under/tomb/indoors)
"kv" = (
/turf/open/water/bath,
/area/under/tomb/indoors)
"mv" = (
/obj/machinery/light/fueled/wallfire/candle/blue,
/turf/open/water/bath,
/area/under/tomb/indoors)
"oo" = (
/mob/living/carbon/human/species/skeleton/npc/ambush,
/turf/open/floor/tile,
/area/under/tomb/indoors)
"oT" = (
/obj/structure/door/swing,
/turf/open/floor/tile,
/area/under/tomb/indoors)
"px" = (
/obj/structure/stairs,
/turf/open/floor/tile,
/area/under/tomb/indoors)
"qU" = (
/obj/effect/decal/cleanable/sigil,
/obj/item/reagent_containers/powder/ozium{
	pixel_y = 2
	},
/obj/item/reagent_containers/powder/ozium{
	pixel_y = 15;
	pixel_x = -19
	},
/obj/item/reagent_containers/powder/ozium{
	pixel_y = 23
	},
/obj/item/reagent_containers/powder/ozium{
	pixel_y = 14;
	pixel_x = 21
	},
/obj/item/reagent_containers/powder/ozium{
	pixel_y = -12;
	pixel_x = -13
	},
/obj/item/reagent_containers/powder/ozium{
	pixel_y = -13;
	pixel_x = 14
	},
/turf/open/floor/ruinedwood/spiral,
/area/under/tomb/indoors)
"qZ" = (
/obj/structure/rack/shelf/big,
/obj/item/perfume/random{
	pixel_y = 24
	},
/obj/item/perfume/random{
	pixel_y = 24;
	pixel_x = 12
	},
/turf/open/floor/ruinedwood/spiral,
/area/under/tomb/indoors)
"ro" = (
/turf/open/openspace,
/area/under/tomb/cave/wet)
"rz" = (
/turf/open/floor/ruinedwood/spiral,
/area/under/tomb/indoors)
"tg" = (
/obj/effect/decal/cleanable/sigil/SE,
/turf/open/floor/ruinedwood/spiral,
/area/under/tomb/indoors)
"ug" = (
/turf/open/floor/naturalstone,
/area/under/tomb/cave/wet)
"uv" = (
/obj/structure/table/vtable,
/obj/item/weapon/knife/dagger/silver{
	pixel_y = 8;
	pixel_x = 6
	},
/turf/open/floor/ruinedwood/spiral,
/area/under/tomb/indoors)
"xm" = (
/obj/structure/rack/shelf/big,
/obj/item/perfume/random{
	pixel_y = 25
	},
/obj/item/perfume/random{
	pixel_y = 27;
	pixel_x = 13
	},
/turf/open/floor/ruinedwood/spiral,
/area/under/tomb/indoors)
"yB" = (
/obj/machinery/light/fueled/wallfire/candle/blue/l,
/turf/open/floor/ruinedwood/spiral,
/area/under/tomb/indoors)
"yX" = (
/obj/effect/dungeon_directional_helper/west,
/turf/open/floor/dirt,
/area/under/tomb/cave/wet)
"AD" = (
/obj/machinery/light/fueled/wallfire/candle/blue,
/obj/structure/bed/shit,
/turf/open/floor/ruinedwood/spiral,
/area/under/tomb/indoors)
"Cj" = (
/obj/item/statue/steel,
/turf/open/floor/tile,
/area/under/tomb/indoors)
"Cy" = (
/obj/effect/dungeon_directional_helper/north,
/turf/open/floor/dirt,
/area/under/tomb/cave/wet)
"CB" = (
/mob/living/carbon/human/species/skeleton/npc/warrior/skilled,
/turf/open/floor/ruinedwood/spiral,
/area/under/tomb/indoors)
"Dh" = (
/turf/open/floor/rooftop{
	dir = 1
	},
/area/under/tomb/cave/wet)
"Ff" = (
/obj/item/soap{
	pixel_x = -3;
	pixel_y = -5
	},
/obj/structure/door/swing,
/turf/open/floor/ruinedwood/spiral,
/area/under/tomb/indoors)
"FC" = (
/turf/open/floor/dirt,
/area/under/tomb/cave/wet)
"Gb" = (
/obj/item/soap/bath{
	pixel_y = -5
	},
/mob/living/carbon/human/species/skeleton/npc/ambush,
/turf/open/water/bath,
/area/under/tomb/indoors)
"Gm" = (
/turf/open/floor/tile,
/area/under/tomb/indoors)
"Ha" = (
/turf/open/floor/rooftop{
	dir = 4
	},
/area/under/tomb/cave/wet)
"If" = (
/obj/structure/door/swing,
/obj/item/soap/bath{
	pixel_y = -5
	},
/turf/open/floor/tile,
/area/under/tomb/indoors)
"Ii" = (
/turf/closed/indestructible/roguewindow,
/area/under/tomb/indoors)
"Iq" = (
/turf/open/floor/rooftop,
/area/under/tomb/cave/wet)
"IM" = (
/obj/effect/decal/cleanable/sigil/E,
/turf/open/floor/ruinedwood/spiral,
/area/under/tomb/indoors)
"IY" = (
/turf/open/water/swamp/deep,
/area/under/tomb/cave)
"JE" = (
/turf/closed/wall/mineral/decowood/vert,
/area/under/tomb/indoors)
"JH" = (
/obj/structure/rack/shelf/big,
/obj/item/perfume/random{
	pixel_y = 24
	},
/obj/item/perfume/random{
	pixel_x = 12;
	pixel_y = 27
	},
/turf/open/floor/ruinedwood/spiral,
/area/under/tomb/indoors)
"JN" = (
/obj/item/gem/violet,
/turf/open/water/bath,
/area/under/tomb/indoors)
"Kf" = (
/obj/machinery/light/fueled/wallfire/candle/blue,
/obj/structure/closet/crate/drawer/inn,
/turf/open/floor/ruinedwood/spiral,
/area/under/tomb/indoors)
"LC" = (
/mob/living/carbon/human/species/skeleton/npc/peasant,
/turf/open/floor/ruinedwood/spiral,
/area/under/tomb/indoors)
"LO" = (
/obj/effect/decal/cleanable/sigil/S,
/turf/open/floor/ruinedwood/spiral,
/area/under/tomb/indoors)
"MS" = (
/mob/living/carbon/human/species/skeleton/npc/ambush,
/turf/open/water/swamp/deep,
/area/under/tomb/cave)
"Nh" = (
/obj/machinery/light/fueled/wallfire/candle/blue,
/obj/structure/closet/crate/drawer/inn,
/obj/item/gem/blue,
/turf/open/floor/ruinedwood/spiral,
/area/under/tomb/indoors)
"Pk" = (
/mob/living/carbon/human/species/zizombie/npc/militiamen,
/obj/item/clothing/ring/gold/gemerald,
/obj/effect/mapping_helpers/floor_clothing_equipper,
/turf/open/floor/ruinedwood/spiral,
/area/under/tomb/indoors)
"Px" = (
/mob/living/carbon/human/species/skeleton/npc/warrior,
/turf/open/floor/ruinedwood/spiral,
/area/under/tomb/indoors)
"RE" = (
/obj/structure/table/vtable/v2,
/obj/item/weapon/knife/dagger/silver{
	pixel_y = 3;
	pixel_x = -3
	},
/obj/item/reagent_containers/powder/moondust,
/obj/item/reagent_containers/powder/moondust{
	pixel_y = 10;
	pixel_x = -13
	},
/obj/item/reagent_containers/powder/moondust{
	pixel_y = 10;
	pixel_x = 10
	},
/turf/open/floor/ruinedwood/spiral,
/area/under/tomb/indoors)
"RU" = (
/obj/effect/decal/cleanable/sigil/NW,
/turf/open/floor/ruinedwood/spiral,
/area/under/tomb/indoors)
"SC" = (
/obj/item/storage/belt/pouch,
/obj/structure/table/vtable/v2,
/turf/open/floor/ruinedwood/spiral,
/area/under/tomb/indoors)
"TO" = (
/obj/effect/dungeon_directional_helper/south,
/turf/open/floor/dirt,
/area/under/tomb/cave/wet)
"WI" = (
/turf/open/floor/rooftop{
	dir = 8
	},
/area/under/tomb/cave/wet)
"WN" = (
/obj/effect/dungeon_directional_helper/east,
/turf/open/floor/dirt,
/area/under/tomb/cave/wet)
"XC" = (
/turf/open/openspace,
/area/under/tomb/indoors)
"Zb" = (
/mob/living/carbon/human/species/skeleton/npc/ambush,
/turf/open/water/swamp/deep,
/area/under/tomb/cave/wet)
"Zk" = (
/obj/machinery/light/fueled/wallfire/candle/blue,
/obj/structure/rack/shelf/big,
/obj/item/perfume/random{
	pixel_y = 25
	},
/obj/item/perfume/random{
	pixel_y = 23;
	pixel_x = 14
	},
/turf/open/floor/ruinedwood/spiral,
/area/under/tomb/indoors)
"Zx" = (
/obj/structure/bed/shit,
/obj/item/statue/iron/deformed,
/turf/open/floor/ruinedwood/spiral,
/area/under/tomb/indoors)
"ZQ" = (
/obj/machinery/light/fueled/wallfire/candle/blue,
/turf/open/floor/tile,
/area/under/tomb/indoors)

(1,1,1) = {"
hr
hr
hr
hr
hr
hr
hr
hr
hr
yX
FC
hr
hr
hr
hr
hr
hr
hr
hr
hr
"}
(2,1,1) = {"
hr
FC
FC
FC
FC
FC
FC
FC
FC
FC
FC
FC
FC
FC
FC
FC
FC
FC
FC
hr
"}
(3,1,1) = {"
hr
FC
bp
bp
bp
bp
bp
bp
bp
bp
bp
bp
bp
bp
bp
bp
bp
bp
FC
hr
"}
(4,1,1) = {"
hr
FC
bp
JE
JE
JE
JE
JE
JE
bp
bp
JE
JE
JE
JE
JE
JE
bp
FC
hr
"}
(5,1,1) = {"
hr
FC
bp
JE
kv
kv
jL
Gm
oT
bp
bp
oT
Gm
jL
kv
kv
JE
bp
FC
hr
"}
(6,1,1) = {"
hr
FC
bp
JE
Gb
kv
kv
Gm
JE
bp
bp
JE
ZQ
kv
kv
kv
JE
bp
FC
hr
"}
(7,1,1) = {"
hr
FC
bp
JE
mv
kv
kv
Cj
JE
bp
bp
JE
Gm
kv
Gb
kv
JE
bp
FC
hr
"}
(8,1,1) = {"
hr
FC
bp
JE
Gm
Gm
Gm
Gm
JE
bp
bp
JE
Gm
Gm
Gm
Gm
JE
bp
FC
hr
"}
(9,1,1) = {"
hr
FC
bp
JE
If
JE
JE
JE
Gm
oo
Gm
Gm
JE
JE
JE
If
JE
bp
FC
hr
"}
(10,1,1) = {"
FC
FC
bp
bp
bp
bp
Zb
bp
Gm
px
JE
Gm
IY
IY
IY
IY
IY
bp
FC
FC
"}
(11,1,1) = {"
Cy
FC
bp
bp
bp
bp
bp
bp
Gm
px
JE
Gm
IY
MS
IY
IY
IY
bp
FC
TO
"}
(12,1,1) = {"
hr
FC
bp
JE
oT
JE
JE
JE
Gm
Gm
Gm
Gm
JE
JE
JE
oT
JE
bp
FC
hr
"}
(13,1,1) = {"
hr
FC
bp
JE
Gm
Gm
Gm
Gm
JE
bp
bp
JE
Gm
Gm
Gm
Gm
JE
bp
FC
hr
"}
(14,1,1) = {"
hr
FC
bp
JE
mv
kv
jL
Gm
JE
bp
bp
JE
ZQ
kv
kv
jL
JE
bp
FC
hr
"}
(15,1,1) = {"
hr
FC
bp
JE
kv
kv
jl
Gm
JE
bp
bp
JE
Gm
jL
kv
jl
JE
bp
FC
hr
"}
(16,1,1) = {"
hr
FC
bp
JE
kv
kv
kv
Gm
If
bp
bp
If
Gm
kv
jl
JN
JE
bp
FC
hr
"}
(17,1,1) = {"
hr
FC
bp
JE
JE
JE
JE
JE
JE
bp
bp
JE
JE
JE
JE
JE
JE
bp
FC
hr
"}
(18,1,1) = {"
hr
FC
bp
bp
bp
bp
bp
bp
bp
bp
bp
bp
bp
bp
bp
bp
bp
bp
FC
hr
"}
(19,1,1) = {"
hr
FC
FC
FC
FC
FC
FC
FC
FC
FC
FC
FC
FC
FC
FC
FC
FC
FC
FC
hr
"}
(20,1,1) = {"
hr
hr
hr
hr
hr
hr
hr
hr
hr
WN
FC
hr
hr
hr
hr
hr
hr
hr
hr
hr
"}

(1,1,2) = {"
hr
hr
hr
hr
hr
hr
hr
hr
ug
ug
ug
ug
hr
hr
hr
hr
hr
hr
hr
hr
"}
(2,1,2) = {"
hr
ro
ro
ro
ro
ro
ro
ro
ro
ro
ro
ro
ro
ro
ro
ro
ro
ro
ro
hr
"}
(3,1,2) = {"
hr
ro
ro
WI
WI
WI
WI
WI
WI
WI
WI
WI
WI
WI
WI
WI
WI
ro
ro
hr
"}
(4,1,2) = {"
hr
ro
Dh
jV
jV
jV
jV
jV
jV
jV
jV
jV
jV
jV
jV
jV
jV
Iq
ro
hr
"}
(5,1,2) = {"
hr
ro
Dh
jV
js
rz
Zx
jV
RU
iO
cA
uv
jV
xm
Pk
rz
jV
Iq
ro
hr
"}
(6,1,2) = {"
hr
ro
Dh
jV
AD
LC
ht
jV
eS
qU
LO
SC
jV
Zk
rz
rz
jV
Iq
ro
hr
"}
(7,1,2) = {"
hr
ro
Dh
jV
hU
rz
ht
jV
cy
IM
tg
rz
jV
qZ
rz
rz
jV
Iq
ro
hr
"}
(8,1,2) = {"
hr
ro
Dh
jV
rz
rz
LC
jV
rz
rz
rz
rz
jV
JH
rz
rz
jV
Iq
ro
hr
"}
(9,1,2) = {"
ug
ro
Dh
jV
jV
Ff
jV
jV
rz
rz
rz
rz
jV
jV
hc
jV
jV
Iq
ro
ug
"}
(10,1,2) = {"
ug
ro
Dh
Ii
rz
rz
rz
rz
rz
XC
il
rz
hL
yB
rz
rz
Ii
Iq
ro
ug
"}
(11,1,2) = {"
ug
ro
Dh
Ii
rz
rz
rz
rz
rz
XC
il
rz
rz
hA
rz
rz
Ii
Iq
ro
ug
"}
(12,1,2) = {"
ug
ro
Dh
jV
jV
jX
jV
jV
rz
rz
rz
rz
jV
jV
jX
jV
jV
Iq
ro
ug
"}
(13,1,2) = {"
hr
ro
Dh
jV
Px
rz
rz
jV
rz
rz
rz
rz
jV
hL
rz
rz
jV
Iq
ro
hr
"}
(14,1,2) = {"
hr
ro
Dh
jV
rz
rz
rz
jV
dx
rz
rz
rz
jV
iy
rz
rz
jV
Iq
ro
hr
"}
(15,1,2) = {"
hr
ro
Dh
jV
Nh
rz
rz
jV
RE
rz
rz
rz
jV
Kf
rz
hL
jV
Iq
ro
hr
"}
(16,1,2) = {"
hr
ro
Dh
jV
fo
rz
CB
jV
Px
rz
rz
rz
jV
fo
rz
rz
jV
Iq
ro
hr
"}
(17,1,2) = {"
hr
ro
Dh
jV
jV
jV
jV
jV
jV
jV
jV
jV
jV
jV
jV
jV
jV
Iq
ro
hr
"}
(18,1,2) = {"
hr
ro
ro
Ha
Ha
Ha
Ha
Ha
Ha
Ha
Ha
Ha
Ha
Ha
Ha
Ha
Ha
ro
ro
hr
"}
(19,1,2) = {"
hr
ro
ro
ro
ro
ro
ro
ro
ro
ro
ro
ro
ro
ro
ro
ro
ro
ro
ro
hr
"}
(20,1,2) = {"
hr
hr
hr
hr
hr
hr
hr
hr
ug
ug
ug
ug
hr
hr
hr
hr
hr
hr
hr
hr
"}
