"a" = (/obj/structure/fluff/walldeco/vinez,/turf/closed/wall/mineral/rogue/stone,/area/rogue/indoors)
"b" = (/obj/structure/fluff/walldeco/vinez,/obj/structure/fluff/walldeco/vinez,/turf/closed/wall/mineral/rogue/stone,/area/rogue/indoors)
"c" = (/obj/effect/decal/cleanable/dirt/cobweb,/turf/open/floor/rogue/cobblerock,/area/rogue/indoors)
"d" = (/obj/effect/dungeon_directional_helper/south,/turf/open/floor/rogue/cobble,/area/rogue/indoors)
"f" = (/obj/machinery/light/rogue/wallfire/candle/weak,/turf/open/floor/rogue/cobblerock,/area/rogue/indoors)
"g" = (/obj/structure/trap/saw_blades,/obj/structure/spider/stickyweb,/turf/open/floor/rogue/cobble,/area/rogue/indoors)
"h" = (/obj/structure/fluff/walldeco/vinez,/turf/closed/wall/mineral/rogue/stone/moss,/area/rogue/indoors)
"i" = (/obj/structure/fluff/walldeco/vinez,/obj/machinery/light/rogue/wallfire/candle/weak,/turf/closed/wall/mineral/rogue/stone,/area/rogue/indoors)
"j" = (/obj/structure/fluff/walldeco/stone,/obj/structure/fluff/walldeco/vinez,/turf/closed/wall/mineral/rogue/stone/moss,/area/rogue/indoors)
"k" = (/obj/effect/dungeon_directional_helper/west,/turf/open/floor/rogue/cobblerock,/area/rogue/indoors)
"l" = (/obj/structure/trap/saw_blades,/obj/structure/spider/stickyweb,/obj/structure/spider/stickyweb{dir = 4},/turf/open/floor/rogue/cobblerock,/area/rogue/indoors)
"m" = (/obj/structure/fluff/walldeco/stone,/obj/structure/fluff/walldeco/vinez,/turf/closed/wall/mineral/rogue/stone,/area/rogue/indoors)
"n" = (/obj/structure/stairs/stone/d,/turf/closed/wall/mineral/rogue/stone,/area/rogue/indoors)
"r" = (/obj/structure/trap/saw_blades,/obj/structure/spider/stickyweb{dir = 8},/turf/open/floor/rogue/cobble,/area/rogue/indoors)
"s" = (/obj/machinery/light/rogue/wallfire/candle/weak,/turf/closed/wall/mineral/rogue/stone,/area/rogue/indoors)
"w" = (/obj/machinery/light/rogue/wallfire/candle/weak,/turf/open/floor/rogue/cobble,/area/rogue/indoors)
"y" = (/obj/structure/fluff/walldeco/vinez,/obj/machinery/light/rogue/wallfire/candle/weak,/turf/closed/wall/mineral/rogue/stone/moss,/area/rogue/indoors)
"B" = (/obj/structure/trap/wall_projectile,/turf/open/floor/rogue/cobblerock,/area/rogue/indoors)
"D" = (/turf/open/transparent/openspace,/area/rogue/indoors)
"E" = (/obj/structure/spider/stickyweb,/obj/structure/spider/stickyweb{dir = 4},/turf/open/floor/rogue/cobble,/area/rogue/indoors)
"H" = (/obj/effect/dungeon_directional_helper/east,/turf/open/floor/rogue/cobble,/area/rogue/indoors)
"I" = (/obj/structure/fluff/walldeco/stone,/turf/closed/wall/mineral/rogue/stone/moss,/area/rogue/indoors)
"J" = (/obj/effect/decal/cleanable/dirt/cobweb{dir = 8},/turf/open/floor/rogue/cobblerock,/area/rogue/indoors)
"L" = (/turf/open/floor/rogue/cobble,/area/rogue/indoors)
"M" = (/obj/structure/trap/wall_projectile{dir = 1},/turf/open/floor/rogue/cobblerock,/area/rogue/indoors)
"O" = (/obj/structure/fluff/walldeco/stone,/turf/closed/wall/mineral/rogue/stone,/area/rogue/indoors)
"P" = (/turf/open/floor/rogue/cobblerock,/area/rogue/indoors)
"R" = (/obj/structure/trap/wall_projectile,/turf/open/floor/rogue/cobble,/area/rogue/indoors)
"S" = (/obj/effect/dungeon_directional_helper/north,/turf/open/floor/rogue/cobblerock,/area/rogue/indoors)
"T" = (/obj/structure/trap/saw_blades,/turf/open/floor/rogue/cobblerock,/area/rogue/indoors)
"U" = (/obj/effect/decal/cleanable/dirt/cobweb/cobweb2,/turf/open/floor/rogue/cobblerock,/area/rogue/indoors)
"V" = (/turf/closed/wall/mineral/rogue/stone,/area/rogue/indoors)
"X" = (/turf/closed/wall/mineral/rogue/stone/moss,/area/rogue/indoors)
"Y" = (/obj/structure/stairs/stone/d,/turf/open/transparent/openspace,/area/rogue/indoors)

(1,1,1) = {"
VmIhLSPahV
hcPPLPPPUh
hPPLLLPPPh
LPPXnnhMMV
kPLsXhiLPP
PLLaVVVPPH
XRBbaahPLL
hPPwLPfPPV
aPPPPLPPPX
aaXXPdPOjh
"}
(1,1,2) = {"
VhhXLLPVhV
aLPPPLLLLX
hLLLPPLLLh
wLLODDjLPa
LLPlYYTPLw
PPPrPJgLLP
aPLIPEmLPP
yLLPLLPLLh
XLLLLPPPLs
VVhhLLPhhV
"}
