//MAP CONVERTED BY dmm2tgm.py THIS HEADER COMMENT PREVENTS RECONVERSION, DO NOT REMOVE
"a" = (
/turf/open/floor/naturalstone,
/area/template_noop)
"e" = (
/turf/open/openspace,
/area/template_noop)
"i" = (
/obj/effect/waterfall,
/turf/open/water/clean,
/area/template_noop)
"o" = (
/turf/closed/mineral,
/area/template_noop)
"s" = (
/turf/open/water/clean,
/area/template_noop)
"y" = (
/turf/template_noop,
/area/template_noop)
"A" = (
/turf/open/floor/dirt,
/area/template_noop)
"N" = (
/obj/effect/waterfall,
/turf/open/openspace,
/area/template_noop)
"Q" = (
/turf/open/floor/cobblerock,
/area/template_noop)

(1,1,1) = {"
y
y
y
a
y
o
o
a
a
a
o
"}
(2,1,1) = {"
y
y
y
a
o
o
a
a
s
s
a
"}
(3,1,1) = {"
y
y
y
a
o
a
a
s
s
s
a
"}
(4,1,1) = {"
y
y
a
o
o
a
s
s
s
s
s
"}
(5,1,1) = {"
y
y
a
o
a
a
i
s
s
s
s
"}
(6,1,1) = {"
y
y
a
o
a
a
i
s
s
s
s
"}
(7,1,1) = {"
y
y
a
o
a
a
s
s
s
s
s
"}
(8,1,1) = {"
y
y
y
a
a
a
a
a
s
s
s
"}
(9,1,1) = {"
y
y
y
y
a
o
a
a
a
s
s
"}
(10,1,1) = {"
y
y
y
y
a
o
y
o
a
a
a
"}
(11,1,1) = {"
y
y
y
y
y
y
y
o
y
o
o
"}

(1,1,2) = {"
y
y
y
y
y
y
y
y
y
y
y
"}
(2,1,2) = {"
y
y
y
y
y
a
o
o
y
y
y
"}
(3,1,2) = {"
y
y
y
y
o
a
a
a
a
o
y
"}
(4,1,2) = {"
y
y
y
o
a
a
e
a
a
a
y
"}
(5,1,2) = {"
y
y
y
o
a
N
e
e
a
a
y
"}
(6,1,2) = {"
y
y
o
o
a
N
e
e
a
o
y
"}
(7,1,2) = {"
y
y
a
a
a
e
e
e
a
o
y
"}
(8,1,2) = {"
y
y
y
a
e
e
e
a
a
y
y
"}
(9,1,2) = {"
y
y
y
o
e
a
e
a
o
a
y
"}
(10,1,2) = {"
y
y
y
o
o
a
a
a
y
y
y
"}
(11,1,2) = {"
y
y
y
y
y
y
y
y
y
y
y
"}

(1,1,3) = {"
y
y
A
A
o
o
o
o
o
y
y
"}
(2,1,3) = {"
y
y
A
o
o
Q
a
Q
o
o
A
"}
(3,1,3) = {"
y
A
o
o
a
A
e
a
A
A
Q
"}
(4,1,3) = {"
y
y
o
A
a
e
e
e
a
Q
A
"}
(5,1,3) = {"
y
A
o
A
N
e
e
e
e
A
y
"}
(6,1,3) = {"
A
o
o
a
N
e
e
e
Q
a
Q
"}
(7,1,3) = {"
A
o
Q
a
e
e
e
e
a
o
A
"}
(8,1,3) = {"
y
o
A
a
e
e
e
a
A
o
y
"}
(9,1,3) = {"
y
o
o
A
Q
e
a
A
o
o
y
"}
(10,1,3) = {"
y
A
o
o
a
Q
A
o
o
y
y
"}
(11,1,3) = {"
y
y
A
o
o
o
o
o
y
y
y
"}

(1,1,4) = {"
y
y
y
y
A
A
A
A
A
y
y
"}
(2,1,4) = {"
y
y
y
A
A
A
o
o
A
y
y
"}
(3,1,4) = {"
y
y
A
A
A
o
o
o
A
A
y
"}
(4,1,4) = {"
y
y
A
A
o
o
o
o
o
A
y
"}
(5,1,4) = {"
y
y
A
A
o
o
o
o
o
A
y
"}
(6,1,4) = {"
y
A
A
o
o
o
o
o
o
A
y
"}
(7,1,4) = {"
y
A
A
o
o
o
o
o
o
A
y
"}
(8,1,4) = {"
y
A
A
A
o
o
o
o
o
A
y
"}
(9,1,4) = {"
y
A
A
A
A
o
o
o
A
A
y
"}
(10,1,4) = {"
y
y
A
A
A
o
o
A
A
y
y
"}
(11,1,4) = {"
y
y
y
y
A
A
A
A
y
y
y
"}
