//MAP CONVERTED BY dmm2tgm.py THIS HEADER COMMENT PREVENTS RECONVERSION, DO NOT REMOVE
"ak" = (
/obj/structure/chair/stool,
/turf/open/floor/naturalstone,
/area/template_noop)
"bB" = (
/obj/structure/stairs/stone{
	dir = 1
	},
/turf/open/floor/naturalstone,
/area/template_noop)
"bS" = (
/obj/structure/table/wood/treestump,
/obj/item/weapon/hoe/stone,
/turf/open/floor/grass,
/area/template_noop)
"cQ" = (
/obj/structure/flora/grass,
/turf/open/water/clean/dirt,
/area/template_noop)
"hD" = (
/turf/open/water/clean,
/area/template_noop)
"iF" = (
/turf/closed/mineral,
/area/template_noop)
"mY" = (
/obj/structure/flora/grass/bush_meagre,
/turf/open/floor/grass,
/area/template_noop)
"oN" = (
/turf/closed/mineral/random,
/area/template_noop)
"uu" = (
/obj/item/reagent_containers/glass/bucket/wooden,
/turf/open/floor/naturalstone,
/area/template_noop)
"vU" = (
/turf/open/floor/naturalstone,
/area/template_noop)
"vW" = (
/obj/effect/lily_petal,
/turf/open/water/clean,
/area/template_noop)
"wu" = (
/turf/template_noop,
/area/template_noop)
"xU" = (
/turf/open/openspace,
/area/template_noop)
"yT" = (
/obj/structure/stairs/stone{
	dir = 1
	},
/turf/template_noop,
/area/template_noop)
"zx" = (
/obj/structure/flora/grass,
/obj/structure/flora/ausbushes/lavendergrass,
/turf/open/floor/grass,
/area/template_noop)
"BL" = (
/obj/structure/flora/grass,
/turf/open/floor/dirt,
/area/template_noop)
"Gc" = (
/obj/structure/flora/grass,
/obj/structure/flora/grass/bush_meagre,
/turf/open/floor/grass,
/area/template_noop)
"Gx" = (
/obj/item/natural/stone,
/turf/open/floor/dirt,
/area/template_noop)
"Hf" = (
/obj/structure/flora/grass/bush_meagre,
/turf/open/floor/dirt,
/area/template_noop)
"Hj" = (
/obj/structure/flora/grass,
/obj/structure/flora/grass/bush_meagre,
/turf/open/floor/dirt,
/area/template_noop)
"Ki" = (
/turf/open/floor/dirt,
/area/template_noop)
"NC" = (
/obj/item/soap,
/turf/open/floor/naturalstone,
/area/template_noop)
"NR" = (
/obj/effect/lily_petal/two,
/turf/open/water/clean,
/area/template_noop)
"OP" = (
/turf/open/floor/grass,
/area/template_noop)
"PR" = (
/turf/open/water/clean/dirt,
/area/template_noop)
"QH" = (
/obj/structure/ladder,
/turf/open/floor/naturalstone,
/area/template_noop)
"Sf" = (
/obj/structure/table/wood/treestump,
/turf/open/floor/dirt,
/area/template_noop)
"Sq" = (
/obj/structure/fluff/statue/small{
	name = "A Lovely Maiden"
	},
/turf/open/water/clean,
/area/template_noop)
"Ss" = (
/obj/structure/flora/ausbushes/lavendergrass,
/turf/open/floor/dirt,
/area/template_noop)
"TD" = (
/obj/structure/flora/grass,
/turf/open/floor/grass,
/area/template_noop)
"TH" = (
/obj/item/natural/stone,
/turf/open/floor/grass,
/area/template_noop)
"UI" = (
/obj/effect/waterfall,
/turf/open/water/clean,
/area/template_noop)
"Wl" = (
/obj/structure/flora/ausbushes/lavendergrass,
/turf/open/floor/grass,
/area/template_noop)
"YJ" = (
/obj/structure/flora/grass,
/obj/structure/flora/ausbushes/lavendergrass,
/turf/open/floor/dirt,
/area/template_noop)
"ZR" = (
/obj/structure/flora/grass/bush_meagre,
/obj/structure/ladder,
/turf/open/floor/grass,
/area/template_noop)

(1,1,1) = {"
wu
wu
wu
wu
wu
wu
wu
iF
iF
iF
iF
iF
iF
iF
wu
wu
wu
wu
wu
wu
wu
"}
(2,1,1) = {"
wu
wu
wu
wu
wu
wu
iF
iF
iF
iF
iF
iF
iF
iF
iF
iF
wu
wu
wu
wu
wu
"}
(3,1,1) = {"
wu
wu
wu
wu
iF
iF
iF
iF
iF
iF
iF
iF
iF
iF
iF
iF
iF
wu
wu
wu
wu
"}
(4,1,1) = {"
wu
wu
wu
iF
iF
iF
iF
iF
iF
iF
iF
iF
iF
iF
iF
iF
iF
iF
wu
wu
wu
"}
(5,1,1) = {"
wu
wu
wu
iF
iF
iF
iF
iF
iF
iF
iF
iF
iF
iF
iF
iF
iF
iF
iF
wu
wu
"}
(6,1,1) = {"
wu
wu
iF
iF
iF
iF
iF
iF
iF
iF
iF
iF
iF
iF
iF
iF
iF
iF
iF
iF
wu
"}
(7,1,1) = {"
wu
iF
iF
iF
iF
iF
iF
iF
iF
iF
iF
iF
iF
iF
iF
iF
iF
iF
iF
iF
wu
"}
(8,1,1) = {"
wu
iF
iF
iF
iF
iF
iF
iF
iF
iF
iF
iF
iF
iF
iF
iF
iF
iF
iF
wu
wu
"}
(9,1,1) = {"
iF
iF
iF
iF
iF
iF
iF
iF
iF
iF
iF
iF
iF
iF
iF
iF
iF
yT
wu
wu
wu
"}
(10,1,1) = {"
iF
iF
iF
iF
iF
iF
iF
iF
iF
iF
iF
iF
iF
iF
iF
iF
iF
yT
wu
wu
wu
"}
(11,1,1) = {"
iF
iF
iF
iF
iF
iF
iF
iF
iF
iF
iF
iF
iF
iF
iF
iF
iF
yT
wu
wu
wu
"}
(12,1,1) = {"
iF
iF
iF
iF
iF
iF
iF
iF
iF
iF
iF
iF
iF
iF
iF
iF
iF
yT
wu
wu
wu
"}
(13,1,1) = {"
iF
iF
iF
iF
iF
iF
iF
iF
iF
iF
iF
iF
iF
iF
iF
iF
iF
iF
iF
wu
wu
"}
(14,1,1) = {"
iF
iF
iF
iF
iF
iF
iF
iF
iF
iF
iF
iF
iF
iF
iF
iF
iF
iF
iF
iF
wu
"}
(15,1,1) = {"
iF
iF
iF
iF
iF
iF
iF
iF
iF
iF
iF
iF
iF
iF
iF
iF
iF
iF
iF
iF
iF
"}
(16,1,1) = {"
wu
iF
iF
iF
iF
iF
iF
iF
iF
iF
iF
iF
iF
iF
iF
iF
iF
iF
iF
iF
iF
"}
(17,1,1) = {"
wu
iF
iF
iF
iF
iF
iF
iF
iF
iF
iF
iF
iF
iF
iF
iF
iF
iF
iF
iF
wu
"}
(18,1,1) = {"
wu
wu
iF
iF
iF
iF
iF
iF
iF
iF
iF
iF
iF
iF
iF
iF
iF
iF
wu
wu
wu
"}
(19,1,1) = {"
wu
wu
iF
iF
iF
iF
iF
iF
iF
iF
iF
iF
iF
iF
iF
iF
iF
wu
wu
wu
wu
"}
(20,1,1) = {"
wu
wu
wu
iF
iF
iF
iF
iF
iF
iF
iF
iF
iF
iF
iF
wu
wu
wu
wu
wu
wu
"}
(21,1,1) = {"
wu
wu
wu
wu
wu
iF
iF
iF
iF
iF
iF
iF
iF
wu
wu
wu
wu
wu
wu
wu
wu
"}

(1,1,2) = {"
wu
wu
wu
wu
wu
wu
wu
Ki
Ki
Ki
Ki
Ki
Ki
Ki
wu
wu
wu
wu
wu
wu
wu
"}
(2,1,2) = {"
wu
wu
wu
wu
wu
wu
Ki
Ki
Ki
iF
iF
iF
iF
Ki
Ki
Ki
wu
wu
wu
wu
wu
"}
(3,1,2) = {"
wu
wu
wu
wu
Ki
Ki
Ki
iF
iF
iF
iF
iF
iF
iF
iF
Ki
Ki
wu
wu
wu
wu
"}
(4,1,2) = {"
wu
wu
wu
Ki
Ki
Ki
iF
iF
oN
oN
oN
oN
oN
iF
iF
iF
iF
Ki
wu
wu
wu
"}
(5,1,2) = {"
wu
wu
wu
Ki
Ki
iF
iF
oN
oN
vU
vU
oN
oN
oN
iF
iF
iF
iF
Ki
wu
wu
"}
(6,1,2) = {"
wu
wu
Ki
Ki
iF
iF
oN
oN
QH
vU
vU
vU
vU
oN
oN
oN
iF
iF
iF
Ki
wu
"}
(7,1,2) = {"
wu
Ki
Ki
iF
iF
oN
oN
hD
vU
vU
hD
vW
vU
vU
vU
oN
oN
iF
iF
iF
wu
"}
(8,1,2) = {"
wu
Ki
iF
iF
oN
oN
vW
hD
vU
hD
hD
hD
NR
vU
vU
oN
oN
iF
iF
iF
wu
"}
(9,1,2) = {"
Ki
Ki
iF
iF
oN
oN
hD
hD
hD
NR
hD
hD
hD
hD
vU
vU
bB
xU
wu
iF
iF
"}
(10,1,2) = {"
Ki
iF
iF
iF
oN
hD
hD
hD
NR
hD
Sq
hD
hD
hD
vU
vU
bB
xU
wu
wu
wu
"}
(11,1,2) = {"
Ki
iF
iF
iF
oN
UI
hD
hD
hD
hD
hD
NR
hD
vU
NC
vU
bB
xU
wu
wu
wu
"}
(12,1,2) = {"
Ki
iF
iF
iF
oN
UI
hD
hD
hD
vW
hD
hD
ak
vU
vU
vU
bB
xU
wu
iF
wu
"}
(13,1,2) = {"
Ki
iF
iF
iF
oN
UI
hD
NR
hD
hD
hD
vU
uu
vU
vU
vU
oN
iF
iF
iF
wu
"}
(14,1,2) = {"
Ki
iF
iF
iF
oN
hD
hD
hD
NR
hD
ak
vU
vU
vU
vU
oN
oN
iF
iF
Ki
wu
"}
(15,1,2) = {"
Ki
Ki
iF
iF
oN
hD
hD
hD
ak
uu
vU
vU
vU
oN
oN
oN
iF
iF
Ki
Ki
Ki
"}
(16,1,2) = {"
wu
Ki
iF
iF
oN
oN
NR
NC
vU
vU
vU
vU
oN
oN
oN
iF
iF
Ki
Ki
Ki
Ki
"}
(17,1,2) = {"
wu
Ki
Ki
iF
oN
oN
oN
oN
oN
oN
oN
oN
oN
iF
iF
iF
Ki
Ki
Ki
Ki
wu
"}
(18,1,2) = {"
wu
wu
Ki
iF
iF
iF
iF
iF
iF
iF
iF
iF
iF
iF
Ki
Ki
Ki
Ki
wu
wu
wu
"}
(19,1,2) = {"
wu
wu
Ki
Ki
iF
iF
iF
iF
iF
iF
iF
iF
iF
Ki
Ki
Ki
Ki
wu
wu
wu
wu
"}
(20,1,2) = {"
wu
wu
wu
Ki
Ki
Ki
Ki
Ki
Ki
Ki
Ki
Ki
Ki
Ki
Ki
wu
wu
wu
wu
wu
wu
"}
(21,1,2) = {"
wu
wu
wu
wu
wu
Ki
Ki
Ki
Ki
Ki
Ki
Ki
Ki
wu
wu
wu
wu
wu
wu
wu
wu
"}

(1,1,3) = {"
wu
wu
wu
wu
wu
wu
wu
xU
xU
xU
xU
xU
xU
xU
wu
wu
wu
wu
wu
wu
wu
"}
(2,1,3) = {"
wu
wu
wu
wu
wu
wu
xU
xU
xU
Ki
Ki
Ki
Ki
xU
xU
xU
wu
wu
wu
wu
wu
"}
(3,1,3) = {"
wu
wu
wu
wu
xU
xU
xU
Ki
Ki
Ki
OP
OP
OP
Ki
Ki
xU
xU
wu
wu
wu
wu
"}
(4,1,3) = {"
wu
wu
wu
xU
xU
xU
Ki
Ki
Ki
BL
TD
OP
OP
OP
OP
OP
Ki
xU
wu
wu
wu
"}
(5,1,3) = {"
wu
wu
wu
xU
xU
Ki
Sf
YJ
YJ
OP
TD
OP
Wl
Wl
mY
Hj
BL
Ki
xU
wu
wu
"}
(6,1,3) = {"
wu
wu
xU
xU
BL
YJ
YJ
Ss
ZR
OP
TD
TD
Wl
Wl
YJ
YJ
Ss
TD
Ki
xU
wu
"}
(7,1,3) = {"
wu
xU
xU
Ss
YJ
Ss
Ss
mY
OP
TD
TD
Ki
OP
TD
TD
Ss
zx
zx
Ss
Ki
wu
"}
(8,1,3) = {"
wu
xU
Ki
Ki
Hf
mY
OP
OP
TD
BL
BL
Ki
Ki
BL
mY
TD
TD
Wl
Wl
Ki
wu
"}
(9,1,3) = {"
xU
xU
Ki
TH
OP
OP
OP
OP
Ki
Ki
Ki
YJ
Ki
Hf
OP
OP
OP
TD
TD
Gx
Ki
"}
(10,1,3) = {"
xU
Ki
OP
OP
Wl
Wl
PR
PR
OP
Sf
Ss
YJ
zx
OP
OP
OP
OP
TD
TD
Ki
Ki
"}
(11,1,3) = {"
xU
Ki
OP
Wl
Wl
PR
PR
cQ
TD
Wl
Wl
mY
Gc
zx
mY
mY
OP
OP
OP
BL
Ki
"}
(12,1,3) = {"
xU
Ki
OP
OP
PR
PR
PR
YJ
Wl
OP
OP
OP
Ki
YJ
YJ
Ss
TD
bS
OP
Ki
Ki
"}
(13,1,3) = {"
xU
Ki
OP
TD
PR
PR
Ss
Ss
Ki
OP
OP
OP
OP
Ki
BL
YJ
Ss
OP
OP
Ki
Ki
"}
(14,1,3) = {"
xU
Ki
BL
TD
BL
YJ
YJ
Ki
Ki
OP
Wl
Wl
TH
Ki
BL
BL
Ki
OP
Ki
Ki
Ki
"}
(15,1,3) = {"
xU
xU
BL
TD
Ki
Ki
Ki
Ki
OP
Wl
Wl
Wl
mY
OP
Ki
Ki
OP
Ki
Ki
xU
xU
"}
(16,1,3) = {"
wu
xU
Ki
BL
TD
BL
Ki
Wl
mY
Wl
Wl
Wl
Wl
Wl
OP
Ki
Ki
Ki
xU
xU
xU
"}
(17,1,3) = {"
wu
xU
xU
Ki
TD
TD
TD
OP
Wl
mY
Wl
Wl
Wl
Ss
Ki
Ki
xU
xU
xU
xU
wu
"}
(18,1,3) = {"
wu
wu
xU
Ki
Ki
Gx
OP
OP
OP
Wl
mY
mY
Ki
Ki
xU
xU
xU
xU
wu
wu
wu
"}
(19,1,3) = {"
wu
wu
xU
xU
Ki
Ki
Ki
Ki
Ki
Ki
Ki
Ki
Ki
xU
xU
xU
xU
wu
wu
wu
wu
"}
(20,1,3) = {"
wu
wu
wu
xU
xU
xU
Ki
Ki
Ki
Ki
Ki
Ki
xU
xU
xU
wu
wu
wu
wu
wu
wu
"}
(21,1,3) = {"
wu
wu
wu
wu
wu
xU
xU
xU
xU
xU
xU
xU
xU
wu
wu
wu
wu
wu
wu
wu
wu
"}
