//MAP CONVERTED BY dmm2tgm.py THIS HEADER COMMENT PREVENTS RECONVERSION, DO NOT REMOVE
"a" = (
/obj/structure/spider/stickyweb,
/turf/open/floor/naturalstone,
/area/template_noop)
"c" = (
/obj/item/alch/herb/rosa,
/turf/open/water/clean,
/area/template_noop)
"g" = (
/turf/closed/mineral,
/area/template_noop)
"j" = (
/turf/template_noop,
/area/template_noop)
"q" = (
/obj/effect/waterfall,
/turf/open/water/clean,
/area/template_noop)
"t" = (
/turf/open/water/clean,
/area/template_noop)
"y" = (
/obj/structure/flora/grass/herb/rosa,
/turf/open/floor/grass/cold,
/area/template_noop)
"C" = (
/turf/open/openspace,
/area/template_noop)
"M" = (
/obj/effect/decal/remains/human,
/turf/open/floor/naturalstone,
/area/template_noop)
"N" = (
/turf/open/floor/grass/cold,
/area/template_noop)
"P" = (
/mob/living/simple_animal/hostile/retaliate/spider/mutated,
/turf/open/floor/naturalstone,
/area/template_noop)
"T" = (
/turf/open/floor/naturalstone,
/area/template_noop)
"X" = (
/obj/effect/waterfall{
	pixel_y = 0
	},
/turf/open/water/clean,
/area/template_noop)

(1,1,1) = {"
j
j
j
j
t
t
t
t
t
t
t
t
t
j
j
j
"}
(2,1,1) = {"
j
j
j
t
t
t
t
t
t
t
t
t
t
t
j
j
"}
(3,1,1) = {"
j
j
t
t
t
g
g
g
g
g
g
g
t
t
t
j
"}
(4,1,1) = {"
j
t
t
t
g
g
T
T
T
M
g
g
g
t
t
t
"}
(5,1,1) = {"
t
t
t
g
a
a
T
P
a
g
g
g
g
g
t
t
"}
(6,1,1) = {"
t
X
g
T
T
T
g
g
g
g
g
a
P
g
X
t
"}
(7,1,1) = {"
t
X
g
a
T
T
T
g
g
T
a
a
a
a
X
t
"}
(8,1,1) = {"
t
X
g
g
a
T
a
g
T
P
a
T
g
g
X
t
"}
(9,1,1) = {"
t
X
g
g
M
T
a
T
a
T
T
g
g
g
t
t
"}
(10,1,1) = {"
t
t
g
g
g
T
T
a
a
T
g
g
g
g
t
t
"}
(11,1,1) = {"
t
t
t
g
g
g
a
T
T
a
g
a
M
g
t
t
"}
(12,1,1) = {"
j
t
t
t
g
g
g
g
P
T
T
T
a
g
t
t
"}
(13,1,1) = {"
j
j
t
t
t
g
g
g
g
g
g
g
g
t
t
t
"}
(14,1,1) = {"
j
j
j
t
t
t
g
g
g
g
g
t
t
t
t
j
"}
(15,1,1) = {"
j
j
j
j
t
t
t
t
q
q
t
t
t
t
j
j
"}
(16,1,1) = {"
j
j
j
j
j
t
t
t
t
t
t
t
j
j
j
j
"}

(1,1,2) = {"
j
j
j
j
C
C
C
C
C
C
C
C
C
j
j
j
"}
(2,1,2) = {"
j
j
j
C
C
C
C
C
C
C
C
C
C
C
j
j
"}
(3,1,2) = {"
j
j
C
C
C
N
N
N
N
N
N
N
C
C
C
j
"}
(4,1,2) = {"
j
C
C
C
N
N
y
t
t
c
T
y
N
C
C
C
"}
(5,1,2) = {"
C
C
C
N
N
y
t
t
t
t
t
T
T
T
C
C
"}
(6,1,2) = {"
C
C
t
t
y
t
t
t
c
t
t
t
t
t
C
C
"}
(7,1,2) = {"
C
C
t
c
t
t
t
t
t
t
t
t
t
c
C
C
"}
(8,1,2) = {"
C
C
t
t
t
t
c
t
t
t
t
c
t
t
C
C
"}
(9,1,2) = {"
C
C
t
t
t
t
t
t
t
t
t
t
t
T
C
C
"}
(10,1,2) = {"
C
C
N
y
t
t
t
t
t
t
t
t
T
y
C
C
"}
(11,1,2) = {"
C
C
C
N
N
y
t
c
t
t
T
y
N
N
C
C
"}
(12,1,2) = {"
j
C
C
C
N
N
y
t
t
T
y
N
N
N
C
C
"}
(13,1,2) = {"
j
j
C
C
C
N
N
t
t
N
N
N
N
C
C
C
"}
(14,1,2) = {"
j
j
j
C
C
C
N
c
t
N
N
C
C
C
C
j
"}
(15,1,2) = {"
j
j
j
j
C
C
C
C
C
C
C
C
C
C
j
j
"}
(16,1,2) = {"
j
j
j
j
j
C
C
C
C
C
C
C
j
j
j
j
"}
